TTTTTTTTTTTTTTTTTTT
T       T         T
T R  T  T   R     T
T    T  T         T
T       TTT   t   T
T                 T
T    T     TT     T
T                 T
TTTTTTTTTTTTTTTTTTT
